# Map file for tile-based game
# (Lines that start with '#' are comments)
# The tiles are:
#   (Space) Empty tile
#   A..Z    Tiles A through Z
#   o       Star
#   !       Music Note
#   *       Goal
#   1       Bad Guy 1 (grub)
#   2       Bad Guy 2 (fly)    6 extra levels up than could be shown
                                                                                                                                                CD========================================================================================================================================================================================================================================AAAAAAAAAAAAAAAAAA
                                                                                                                                                CD========================================================================================================================================================================================================================================AAAAAAAAAAAAAAAAAA
                                                                                                                                                CD========================================================================================================================================================================================================================================AAAAAAAAAAAAAAAAAA
                                                                                                                                                CD                                                                                                                                                                                                                                        AAAAAAAAAAAAAAAAAA
                                                                                                                                                CD                                                                                                                                                                                                                                        AAAAAAAAAAAAAAAAAA
                                                                                                                      o                    o    CD                                                                                                                                                                                                     o  EBBBBBBBBBBBBBBF  EBBBBBBBBBBBBBAAAAAAAAAAAAAAAAAA        
                                                                                                                                                CD                                                                                                                                                                                                        C                               AAAAAAAAAAAAAAAAAA
                                                                                o                        o  EBBBBBBBBBBBBBBBBBBBBBBBBBBBBBBBBF  CHBF                                                                                                                                                                                     o  EBBBBBBBBBBBBBG                               AAAAAAAAAAAAAAAAAA
                                IIII                                                                        CAAAAAAAAAAAAAAAAAAAAAAAAAAAAAAAAD  CAAHBF                                                                                                                                                                                      CAAAAAAAAAAAAAA                               AAAAAAAAAAAAAAAAAA
                                      IIII                       o  EBBBBBBBBBBBBBBBBBBBBBBBBBBBBBBBBBBBBBBBGAAAAAAAAAAAAAAAAAAAAAAAAAAAAAAAAD  CAAAAHBF                                                                                                                                                                 o  EBBBBBBBBBBBBBBBGAAAAAAAAAAAAAA                               AAAAAAAAAAAAAAAAAA
                                                                    CAAAAAAAAAAAAAAAAAAAAAAAAAAAAAAAAAAAAAAAAAAAAAAAAAAAAAAAAAAAAAAAAAAAAAAAAD  CAAAAAAHBF                                 o            IIII                                                                                                                CAAAAAAAAAAAAAAAAAAAAAAAAAAAAAA                               AAAAAAAAAAAAAAAAAA
                          IIII              EBBBBBBBBBBBBBBBBBBBBBBBGAAAAAAAAAAAAAAAAAAAAAAAAAAAAAAAAAAAAAAAAAAAAAAAAAAAAAAAAAAAAAAAAAAAAAAAAD  CAAAAIIIIIIIII                                                                                                                                           o  EBBBBBBBBBBBBBBBGAAAAAAAAAAAAAAAAAAAAAAAAAAAAAA                               AAAAAAAAAAAAAAAAAA
                                            IIIIIAAAAAAAAAAAAAAAAAAAAAAAAAAAAAAAAAAAAAAAAAAAAAAAAAAAAAAAAAAAAAAAAAAAAIIIIIIIIIIIIIIIIIIIIIIAAD  CAAIII                              IIII  IIII   IIII         IIII                                                                                          CAAAAAAAAAAAAAAAAAAAAAAAAAAAAAAAAAAAAAAAAAAAAAA                               AAAAAAAAAAAAAAAAAA
                                                IAAAAAAAAAAAAAAAAAAAAAAAAAAAAAAAAAAAAAAAAAAAAAAAAAAAAIIIIIIIAAAIIIIIII                    IIID  CII                           o                                                                                                          o  EBBBBBBBBBBBBBBBGAAAAAAAAAAAAAAAAAAAAAAAAAAAAAAAAAAAAAAAAAAAAAA                               AAAAAAAAAAAAAAAAAA
                                IIII            IIIIIAAAAAAAAAAAAAAAAAAAAAAAAAAAAAAAAAAAAAAAAAAAAAAAII     IIIII                            II  II                                                                                                                                          CAAAAAAAAAAAAAAAAAAAAAAAAAAAAAAAAAAAAAAAAAAAAAAAAAAAAAAAAAAAAAA             IIII              AAAAAAAAAAAAAAAAAA
                                                    IAAAAAAAAAAAIIIIIIIIIAAIIIIIIIAAIIIIIIIIIIIIIIIII                                        I                                IIII                                  IIII                                                 o  EBBBBBBBBBBBBBBBGAAAAAAAAAAAAAAAAAAAAAAAAAAAAAAAAAAAAAAAAAAAAAAAAAAAAAAAAAAAAAA                               AAAAAAAAAAAAAAAAAA
                                                    IIIIIIIIIIIII       IIII     IIII                                                                                                                                                                                       CAAAAAAAAAAAAAAAAAAAAAAAAAAAAAAAAAAAAAAAAAAAAAAAAAAAAAAAAAAAAAAAAAAAAAAAAAAAAAA                               AAAAAAAAAAAAAAAAAA
                                      EBBF                                                                                                                                                                                                               o  EBBBBBBBBBBBBBBBGAAAAAAAAAAAAAAAAAAAAAAAAAAAAAAAAAAAAAAAAAAAAAAAAAAAAAAAAAAAAAAAAAAAAAAAAAAAAAA       IIII        IIII        AAAAAAAAAAAAAAAAAA
                                      CAAD                                                                                                                                          IIII                                                                    CAAAAAAAAAAAAAAAAAAAAAAAAAAAAAAAAAAAAAAAAAAAAAAAAAAAAAAAAAAAAAAAAAAAAAAAAAAAAAAAAAAAAAAAAAAAAAA                               AAAAAAAAAAAAAAAAAA
                                    EBGAAHBF                                                                                    EBBBBBBBBBBBBBBBBBBBBBBBBBBBBF                                                                              EBBBBBBBBBBBBBBBGAAAAAAAAAAAAAAAAAAAAAAAAAAAAAAAAAAAAAAAAAAAAAAAAAAAAAAAAAAAAAAAAAAAAAAAAAAAAAAAAAAAAAAAAAAAAAA                               AAAAAAAAAAAAAAAAAA
                                    CAAAAAAD                                                                                    CAAAAAAAAAAAAAAAAAAAAAAAAAAAAD                                                                              CAAAAAAAAAAAAAAAAAAAAAAAAAAAAAAAAAAAAAAAAAAAAAAAAAAAAAAAAAAAAAAAAAAAAAAAAAAAAAAAAAAAAAAAAAAAAAAAAAAAAAAAAAAAAAA IIII                     IIII AAAAAAAAAAAAAAAAAA
                EBBF      s       EBGAAAAAAHBF         s             s               s              s   EBBBBBBBBBBBBBBBBBBBBBBBGAAAAAAAAAAAAAAAAAAAAAAAAAAAAHBBBBBBBBBBBBBBBBBBBBBF        s         s          s        s EBBBBBBBBBBBBBBBGAAAAAAAAAAAAAAAAAAAAAAAAAAAAAAAAAAAAAAAAAAAAAAAAAAAAAAAAAAAAAAAAAAAAAAAAAAAAAAAAAAAAAAAAAAAAAAAAAAAAAAAAAAAAAA                               AAAAAAAAAAAAAAAAAA
                CAAD              CAAAAAAAAAAD                                                          CAAAAAAAAAAAAAAAAAAAAAAAAAAAAAAAAAAAAAAAAAAAAAAAAAAAAAAAAAAAAAAAAAAAAAAAAAAD                                        CAAAAAAAAAAAAAAAAAAAAAAAAAAAAAAAAAAAAAAAAAAAAAAAAAAAAAAAAAAAAAAAAAAAAAAAAAAAAAAAAAAAAAAAAAAAAAAAAAAAAAAAAAAAAAAAAAAAAAAAAAAAAAA                               AAAAAAAAAAAAAAAAAA
BBBBBBBBBBBBBBBBGAAHBBBBBBBBBBBBBBGAAAAAAAAAAHBBBBBBBBBBBBBBBBBBBBBBBBBBBBBBBBBBBBBBBBBBBBBBBBBBBBBBBBBBGAAAAAAAAAAAAAAAAAAAAAAAAAAAAAAAAAAAAAAAAAAAAAAAAAAAAAAAAAAAAAAAAAAAAAAAAAAHBBBBBBBBBBBBBBBBBBBBBBBBBBBBBBBBBBBBBBBBGAAAAAAAAAAAAAAAAAAAAAAAAAAAAAAAAAAAAAAAAAAAAAAAAAAAAAAAAAAAAAAAAAAAAAAAAAAAAAAAAAAAAAAAAAAAAAAAAAAAAAAAAAAAAAAAAAAAAAAAAAAAAAAAAAAAAAAAAAAAAAAAAAAAAAAAAAAAAAAAAAAAAAAAAAAAAAAA
AAAAAAAAAAAAAAAAAAAAAAAAAAAAAAAAAAAAAAAAAAAAAAAAAAAAAAAAAAAAAAAAAAAAAAAAAAAAAAAAAAAAAAAAAAAAAAAAAAAAAAAAAAAAAAAAAAAAAAAAAAAAAAAAAAAAAAAAAAAAAAAAAAAAAAAAAAAAAAAAAAAAAAAAAAAAAAAAAAAAAAAAAAAAAAAAAAAAAAAAAAAAAAAAAAAAAAAAAAAAAAAAAAAAAAAAAAAAAAAAAAAAAAAAAAAAAAAAAAAAAAAAAAAAAAAAAAAAAAAAAAAAAAAAAAAAAAAAAAAAAAAAAAAAAAAAAAAAAAAAAAAAAAAAAAAAAAAAAAAAAAAAAAAAAAAAAAAAAAAAAAAAAAAAAAAAAAAAAAAAAAAAAAAAAAAAAAAA